==1==
|-                   /
| #######      #     /
|%%%%%%%%%%%%%% %%%%%/
|  %                 /
|      %  #   #   %  /
|               #    /
|       %  +#%  #    /
|  %      # #        /
|      %          %  /
|                    /